OPZ = "countries/Kherson.txt"
CRI = "countries/Crimea.txt"
MYK = "countries/Mykolayiv.txt"
ODE = "countries/Odesa.txt"
DPR = "countries/DPR.txt"
LPR = "countries/LPR.txt"
AFU = "countries/Armed Forces.txt"
ZAP = "countries/Zaporizhia.txt"
DNI = "countries/Dnipro.txt"
TRA = "countries/Transnistria.txt"
KHC = "countries/KharkivCom.txt"
KHA = "countries/Kharkiv.txt"
SUM = "countries/Summy.txt"
PRH = "countries/Poroshenko.txt"
KYI = "countries/Kyiv.txt"
UKR = "countries/Ukraine.txt"
CHR = "countries/Cherkasy.txt"
UMA = "countries/Uman.txt"
KIR = "countries/Kirovograd.txt"
PLT = "countries/Poltava.txt"
KRE = "countries/Kremenchuk.txt"
ZHY = "countries/Zhytomyr.txt"
RIV = "countries/Rivne.txt"
VOL = "countries/Volhyn.txt"
KHM = "countries/Khmelnistky.txt"
ROM = "countries/Chernivtsy.txt"
TER = "countries/Ternopil.txt"
ZAK = "countries/Transcarpathia.txt"
GAL = "countries/Galychyna.txt"
GUT = "countries/Gutsuly.txt"